R 800 600
NO ./assets/crystal.xpm
SO ./assets/crystal_imac.xpm
WE ./assets/crystal_box.xpm
EA ./assets/crystal_sign.xpm
S ./assets/vlc.xpm
F 79,0,45
C 45,250,0

111111111111111
100000000000001
100S001111111111111111
1000001000000000000001
1000000000000000000001
1000001200000000000001
1111111111111111111111
